6,6,6,6,6,6,6,6,6,6,6,6,6,6,6,6,6,6,6,6,6,6,6,6,6,6,6,6,6,6,6,6,6,6,6,6,6,6,6,6,6,6,6,6,6,6,6,6,6,6,6,6,6,6,6,6,6,6,6,6,6,6,6,6,6,6,6,6,6,6,6,6,6,6,6,6,6,6,6,6,6,6,6,6,6,6,6,6,6,6,6,6,6,6,6,6,6,6,6,6
6,6,6,6,6,6,6,6,6,6,6,6,6,6,6,6,6,6,6,6,6,6,6,6,6,6,6,6,6,6,6,6,6,6,6,6,6,6,6,6,6,6,6,6,6,6,6,6,6,6,6,6,6,6,6,6,6,6,6,6,6,6,6,6,6,6,6,6,6,6,6,6,6,6,6,6,6,6,6,6,6,6,6,6,6,6,6,6,6,6,6,6,6,6,6,6,6,6,6,6
6,6,6,6,6,6,6,6,6,6,6,6,6,6,6,6,6,6,6,6,6,6,6,6,6,6,6,6,6,6,6,6,6,6,6,6,6,6,6,6,6,6,6,6,6,6,6,6,6,6,6,6,6,6,6,6,6,6,6,6,6,6,6,6,6,6,6,6,6,6,6,6,6,6,6,6,6,6,6,6,6,6,6,6,6,6,6,6,6,6,6,6,6,6,6,6,6,6,6,6
6,6,6,6,6,6,6,6,6,6,6,6,6,6,6,6,6,6,6,6,6,6,6,6,6,6,6,6,6,6,6,6,6,6,6,6,6,6,6,6,6,6,6,6,6,6,6,6,6,6,6,6,6,6,6,6,6,6,6,6,6,6,6,6,6,6,6,6,6,6,6,6,6,6,6,6,6,6,6,6,6,6,6,6,6,6,6,6,6,6,6,6,6,6,6,6,6,6,6,6
6,6,6,6,6,6,6,6,6,6,6,6,6,6,6,6,6,6,6,6,6,6,6,6,6,6,6,6,6,6,6,6,6,6,6,6,6,6,6,6,6,6,6,6,6,6,6,6,6,6,6,6,6,6,6,6,6,6,6,6,6,6,6,6,6,6,6,6,6,6,6,6,6,6,6,6,6,6,6,6,6,6,6,6,6,6,6,6,6,6,6,6,6,6,6,6,6,6,6,6
6,6,6,6,6,6,6,6,6,6,6,6,6,6,6,6,6,6,6,6,6,6,6,6,6,6,6,6,6,6,6,6,6,6,6,6,6,6,6,6,6,6,6,6,6,6,6,6,6,6,6,6,6,6,6,6,6,6,6,6,6,6,6,6,6,6,6,6,6,6,6,6,6,6,6,6,6,6,6,6,6,6,6,6,6,6,6,6,6,6,6,6,6,6,6,6,6,6,6,6
6,6,6,6,6,6,6,5,5,5,5,5,5,5,5,5,5,5,5,5,5,5,5,5,5,5,5,5,5,5,5,5,5,5,5,5,5,5,5,5,5,5,5,5,5,5,5,5,5,5,5,5,5,5,5,5,5,5,5,5,5,5,5,5,5,5,5,5,5,5,5,5,5,5,5,5,5,5,5,5,5,5,5,5,5,5,5,5,5,5,5,5,5,5,6,6,6,6,6,6
6,6,6,6,6,6,6,5,5,5,5,5,5,5,5,5,5,5,5,5,5,5,5,5,5,5,5,5,5,5,5,5,5,5,5,5,5,5,5,5,5,5,5,5,5,5,5,5,5,5,5,5,5,5,5,5,5,5,5,5,5,5,5,5,5,5,5,5,5,5,5,5,5,5,5,5,5,5,5,5,5,5,5,5,5,5,5,5,5,5,5,5,5,5,6,6,6,6,6,6
6,6,6,6,6,6,6,5,5,5,5,5,5,5,5,5,5,5,5,5,5,5,5,5,5,5,5,5,5,5,5,5,5,5,5,5,5,5,5,5,5,5,5,5,5,5,5,5,5,5,5,5,5,5,5,5,5,5,5,5,5,5,5,5,5,5,5,5,5,5,5,5,5,5,5,5,5,5,5,5,5,5,5,5,5,5,5,5,5,5,5,5,5,5,6,6,6,6,6,6
6,6,6,6,6,6,6,5,5,5,3,3,3,3,3,3,3,3,3,3,3,3,3,3,3,3,3,3,3,3,3,3,3,3,3,3,3,3,3,3,3,3,7,7,7,7,7,7,7,7,7,7,7,7,7,4,4,5,5,5,5,5,5,5,5,5,5,5,5,5,5,5,5,5,4,4,4,4,4,4,4,4,4,4,4,4,4,4,5,5,5,5,5,5,6,6,6,6,6,6
6,6,6,6,6,6,6,5,5,5,5,5,3,3,3,3,3,3,3,3,3,3,3,3,3,3,3,3,3,3,3,3,3,3,3,3,3,3,3,3,3,3,7,7,7,7,7,7,7,7,7,7,7,7,7,1,4,5,5,5,5,5,5,5,5,5,5,5,5,5,5,5,5,5,4,7,7,4,4,4,4,4,4,4,4,4,4,4,4,4,5,5,5,5,6,6,6,6,6,6
6,6,6,6,6,6,6,5,5,5,5,5,5,5,5,3,3,3,3,3,3,3,3,3,3,7,7,7,7,7,7,7,7,7,7,7,7,7,7,7,7,7,7,7,7,7,7,7,7,7,7,1,1,1,1,1,4,4,4,4,4,4,5,5,5,5,5,5,5,5,5,5,4,4,7,7,7,7,7,7,4,4,4,4,4,4,4,4,4,4,5,5,5,5,6,6,6,6,6,6
6,6,6,6,6,6,6,5,5,5,5,5,5,3,3,3,3,3,3,3,3,7,7,7,7,7,7,7,7,7,7,7,7,7,7,7,7,7,7,7,7,7,7,7,7,7,7,7,7,7,1,1,1,1,1,1,1,7,7,7,7,4,5,5,5,5,5,5,5,5,5,5,4,7,7,7,7,7,7,7,4,4,4,4,4,4,4,4,4,4,5,5,5,5,6,6,6,6,6,6
6,6,6,6,6,6,6,5,5,5,5,5,3,3,3,3,3,3,7,7,7,7,7,7,7,7,7,7,7,7,7,7,7,7,7,7,7,7,7,7,7,7,7,7,7,7,7,7,1,1,1,1,3,3,3,3,3,3,7,7,7,4,4,4,4,4,4,4,4,4,4,4,4,7,7,7,7,7,7,7,7,7,7,7,4,4,4,4,4,4,4,5,5,5,6,6,6,6,6,6
6,6,6,6,6,6,6,5,5,5,5,3,3,3,3,3,3,7,7,7,7,7,7,7,7,7,7,7,7,7,7,7,7,7,7,7,7,7,7,7,7,7,7,7,7,7,7,1,1,1,1,3,3,3,3,3,3,3,3,3,7,7,3,3,3,7,7,7,7,7,7,7,7,7,7,7,7,7,7,7,7,7,7,7,4,4,4,4,4,4,4,5,5,5,6,6,6,6,6,6
6,6,6,6,6,6,6,5,5,5,3,3,3,3,7,7,3,7,7,7,7,7,7,7,7,7,7,7,7,7,7,7,7,7,7,7,7,7,7,7,7,7,7,7,1,1,1,1,1,4,4,4,3,3,8,8,8,3,3,3,3,3,3,3,3,3,3,3,7,7,7,7,7,7,7,7,7,7,7,7,7,7,7,7,4,4,4,4,4,4,4,5,5,5,6,6,6,6,6,6
6,6,6,6,6,6,6,5,5,5,3,3,3,3,7,7,7,7,7,7,7,7,7,7,7,7,7,7,7,7,7,7,7,7,7,7,7,7,7,7,7,1,1,1,1,1,1,4,4,4,4,4,3,8,8,8,8,8,8,5,3,3,3,3,3,3,3,1,1,7,7,7,7,7,7,7,7,7,7,7,7,7,7,7,4,4,4,4,4,4,4,5,5,5,6,6,6,6,6,6
6,6,6,6,6,6,6,5,5,5,3,3,3,4,1,1,1,1,1,7,7,7,7,7,7,7,7,7,7,7,7,7,7,7,7,7,7,7,7,7,1,1,1,1,1,1,4,4,4,4,4,4,3,8,8,8,8,8,8,5,1,1,3,3,3,3,1,7,7,7,7,7,7,7,7,7,7,7,7,7,7,7,7,7,7,7,7,4,4,4,4,5,5,5,6,6,6,6,6,6
6,6,6,6,6,6,6,5,5,5,3,3,4,4,1,1,1,1,1,1,1,1,7,7,7,7,7,7,7,7,7,7,7,7,7,7,1,1,1,1,1,1,3,1,1,4,4,4,4,4,4,3,3,8,8,8,8,5,5,5,5,5,1,3,3,1,1,1,1,1,1,7,7,7,7,7,7,7,7,7,7,7,7,7,7,7,7,4,4,4,4,5,5,5,6,6,6,6,6,6
6,6,6,6,6,6,6,5,5,5,3,3,4,4,1,1,1,1,1,1,1,1,1,7,7,7,1,1,1,7,7,7,7,7,1,1,1,1,1,1,1,1,3,1,1,1,4,4,4,4,3,3,4,8,8,8,5,5,5,5,5,5,5,5,3,5,5,1,5,1,1,7,7,7,7,7,7,7,7,7,7,7,7,7,7,7,7,4,4,4,4,5,5,5,6,6,6,6,6,6
6,6,6,6,6,6,6,5,5,5,3,4,4,4,1,1,1,1,1,1,1,1,1,1,7,1,1,1,1,1,1,7,7,1,1,3,3,3,3,1,1,1,1,1,1,1,4,4,4,3,3,4,1,1,8,8,5,5,5,5,5,5,6,5,5,5,5,5,5,5,1,7,7,7,7,7,7,7,7,7,7,7,7,7,7,7,7,4,4,4,4,5,5,5,6,6,6,6,6,6
6,6,6,6,6,6,6,5,5,5,3,4,4,4,1,1,1,1,1,1,1,5,1,1,1,1,1,1,1,1,1,7,1,1,1,1,1,1,1,1,1,2,1,1,1,1,1,4,4,4,4,4,1,1,8,5,5,5,5,5,6,6,6,6,6,5,5,5,5,5,1,7,7,7,7,7,7,7,7,7,7,7,7,7,7,7,7,7,4,4,4,5,5,5,6,6,6,6,6,6
6,6,6,6,6,6,6,5,5,5,4,4,4,4,1,1,1,1,1,1,1,5,2,2,2,2,2,2,2,1,1,1,1,1,1,1,1,1,1,1,2,2,2,1,1,1,1,1,4,4,4,1,1,1,5,5,5,5,5,6,6,6,6,6,6,6,5,5,5,1,1,7,7,7,7,7,7,7,7,7,7,7,7,7,7,7,7,7,4,4,4,5,5,5,6,6,6,6,6,6
6,6,6,6,6,6,6,5,5,5,4,4,4,4,1,1,1,1,1,1,5,5,2,2,2,2,2,2,2,2,2,2,2,2,2,2,2,2,2,2,2,2,2,2,2,1,1,4,4,4,4,1,1,5,5,5,5,6,6,6,6,6,6,6,6,6,6,5,5,1,1,1,7,7,7,7,7,7,7,7,7,7,7,7,7,7,7,7,7,7,4,5,5,5,6,6,6,6,6,6
6,6,6,6,6,6,6,5,5,5,5,4,4,4,1,1,1,1,2,2,5,2,2,2,2,2,2,2,2,3,2,2,2,2,2,2,2,2,2,2,2,2,2,2,1,1,1,1,4,4,1,1,1,8,8,5,5,5,5,5,6,6,6,6,6,6,6,6,5,5,1,1,7,7,7,7,7,7,7,7,7,7,7,7,7,7,7,7,7,7,4,5,5,5,6,6,6,6,6,6
6,6,6,6,6,6,6,5,5,5,5,4,4,4,1,1,2,2,2,2,5,5,2,2,2,2,2,2,2,3,2,2,2,2,2,2,2,2,2,2,2,2,1,1,1,1,3,1,4,4,1,1,8,8,8,8,5,5,5,5,5,5,6,6,6,6,5,5,5,5,1,1,7,7,7,7,7,7,7,7,7,7,7,7,7,7,7,7,7,7,4,5,5,5,6,6,6,6,6,6
6,6,6,6,6,6,6,5,5,5,5,4,4,4,1,2,2,2,2,2,2,5,2,2,2,2,2,3,2,2,2,2,2,2,2,2,2,2,2,1,1,1,1,4,4,1,3,1,4,4,1,1,1,8,8,8,5,5,1,1,1,1,5,5,6,5,5,5,5,5,5,1,1,7,7,7,7,7,7,7,7,7,7,7,7,7,7,7,7,7,4,5,5,5,6,6,6,6,6,6
6,6,6,6,6,6,6,5,5,5,4,4,4,4,1,2,2,2,2,2,2,5,2,2,3,3,2,3,3,3,2,2,2,2,2,2,2,1,1,1,1,1,1,4,4,1,1,1,4,1,1,1,1,1,1,1,1,5,5,5,1,1,5,5,5,5,5,5,5,5,5,1,1,7,7,2,2,7,7,7,7,7,7,7,7,7,7,7,7,7,4,5,5,5,6,6,6,6,6,6
6,6,6,6,6,6,6,5,5,5,4,4,4,4,2,2,2,2,2,2,2,5,2,2,3,3,2,2,2,2,2,2,2,2,2,2,1,1,1,1,1,1,4,4,4,1,1,1,4,1,1,1,1,8,8,8,8,8,8,8,8,1,1,5,5,5,1,1,5,5,1,1,1,7,2,2,2,2,1,2,7,7,7,7,7,7,7,7,7,7,7,5,5,5,6,6,6,6,6,6
6,6,6,6,6,6,6,5,5,5,4,4,4,4,2,2,2,2,2,2,2,5,2,2,3,3,2,2,2,2,2,2,2,2,1,1,1,1,1,1,1,1,4,4,4,1,1,1,1,1,1,1,1,1,1,8,8,8,8,8,8,1,1,5,1,1,1,1,1,5,1,1,1,7,2,2,2,2,1,2,2,2,7,7,7,7,7,7,7,7,7,5,5,5,6,6,6,6,6,6
6,6,6,6,6,6,6,5,5,5,4,4,4,4,2,2,2,2,2,2,2,5,5,2,2,2,2,2,2,2,2,2,2,1,1,1,1,1,1,1,4,4,4,4,4,4,1,1,1,1,1,1,1,1,1,1,1,1,1,1,1,1,1,1,1,1,1,1,1,1,1,1,1,2,1,1,1,1,1,1,2,2,2,2,7,7,7,7,5,7,7,5,5,5,6,6,6,6,6,6
6,6,6,6,6,6,6,5,5,5,3,3,3,4,2,2,2,2,2,2,2,2,5,5,5,5,2,2,2,2,2,2,1,2,2,2,2,2,1,1,4,4,4,4,4,4,4,4,1,1,4,4,1,1,1,1,1,1,1,1,1,2,2,1,1,1,1,2,2,2,2,2,2,2,1,1,1,2,2,2,2,2,2,2,2,7,7,5,5,5,7,5,5,5,6,6,6,6,6,6
6,6,6,6,6,6,6,5,5,5,3,3,3,4,2,2,2,2,2,2,2,1,1,1,1,5,2,2,2,2,2,1,2,2,2,2,2,2,2,4,4,4,4,4,4,4,4,4,1,4,4,4,4,4,1,1,1,1,1,1,1,2,2,2,2,2,1,1,1,1,1,1,1,1,1,1,1,2,2,2,2,2,2,2,2,7,5,5,5,5,7,5,5,5,6,6,6,6,6,6
6,6,6,6,6,6,6,5,5,5,3,3,3,4,2,2,2,4,4,4,1,1,1,1,1,5,2,2,2,2,2,2,2,2,2,2,2,2,2,4,4,4,4,3,4,4,4,4,4,4,4,4,4,4,4,4,4,4,1,1,1,1,2,2,2,3,3,1,1,1,1,1,1,1,2,2,2,2,2,2,2,2,2,2,2,2,2,2,5,5,5,5,5,5,6,6,6,6,6,6
6,6,6,6,6,6,6,5,5,5,4,4,4,4,2,2,2,4,4,1,1,1,1,1,1,5,2,2,2,2,2,2,2,2,2,2,2,2,4,4,4,4,4,4,4,4,4,4,4,4,4,4,4,4,1,1,1,1,1,1,1,1,1,1,1,3,3,1,1,1,1,1,1,1,2,2,2,2,2,2,2,2,2,2,2,1,2,2,5,5,5,5,5,5,6,6,6,6,6,6
6,6,6,6,6,6,6,5,5,5,4,4,4,4,2,4,4,4,1,1,1,1,1,1,1,5,2,2,2,2,2,2,2,2,2,2,2,2,4,4,4,4,4,4,4,4,4,4,4,4,4,4,4,4,4,4,1,2,2,2,2,1,1,1,1,1,1,1,1,1,2,2,2,2,2,2,2,2,2,2,2,2,2,2,2,1,2,2,5,5,5,5,5,5,6,6,6,6,6,6
6,6,6,6,6,6,6,5,5,5,4,4,4,4,2,4,4,4,1,1,1,1,1,1,1,5,2,2,2,2,2,2,2,3,3,2,2,4,4,4,4,4,4,4,4,4,4,3,3,4,4,4,4,4,1,1,1,2,2,1,1,1,1,1,1,1,3,1,1,1,2,2,2,2,1,1,1,1,1,2,2,2,2,1,1,1,2,2,5,5,5,5,5,5,6,6,6,6,6,6
6,6,6,6,6,6,6,5,5,5,4,4,4,4,4,4,4,4,1,1,1,1,1,3,1,5,5,2,2,2,2,2,5,2,2,2,2,2,4,4,4,4,4,4,4,4,4,4,4,4,4,4,4,4,4,1,2,2,2,1,1,1,1,1,1,1,3,1,1,1,1,1,2,2,1,1,1,1,1,2,2,2,2,1,1,1,2,2,5,5,5,5,5,5,6,6,6,6,6,6
6,6,6,6,6,6,6,5,5,5,4,4,4,4,4,4,4,4,1,4,4,1,1,1,1,1,5,5,2,2,2,5,5,5,2,2,2,4,4,4,4,4,4,4,4,4,4,4,4,4,4,4,4,4,4,1,1,1,1,1,1,1,1,1,3,3,1,1,1,1,1,1,1,1,1,1,1,1,1,1,2,2,2,1,1,1,2,2,5,5,5,5,5,5,6,6,6,6,6,6
6,6,6,6,6,6,6,5,5,5,4,4,4,4,4,4,4,4,4,4,4,1,1,1,1,1,1,5,5,5,5,5,5,5,5,2,2,2,4,4,4,4,4,4,4,4,4,4,4,4,4,4,4,4,4,1,2,1,1,3,3,1,1,1,1,1,1,1,1,1,1,1,1,3,1,1,1,1,1,1,1,1,1,1,1,1,1,1,5,5,5,2,5,5,6,6,6,6,6,6
6,6,6,6,6,6,6,5,5,5,4,4,4,4,4,4,4,4,4,1,1,1,1,1,1,1,1,1,1,1,1,5,5,5,2,2,2,2,4,4,4,4,4,4,4,4,4,4,4,4,4,4,4,4,1,1,2,1,1,1,1,1,1,1,1,1,8,8,8,8,1,1,1,3,1,1,1,1,1,1,1,1,1,1,1,1,1,2,5,5,5,2,5,5,6,6,6,6,6,6
6,6,6,6,6,6,6,5,5,5,4,4,4,4,4,4,4,4,1,1,1,1,1,1,1,3,1,1,1,1,1,1,5,2,2,2,2,1,1,1,4,4,4,4,4,4,1,1,4,4,4,4,4,1,1,1,2,2,2,1,1,1,1,3,1,1,1,1,1,1,1,1,1,1,8,1,1,3,3,3,3,1,1,1,1,2,2,2,5,2,2,2,5,5,6,6,6,6,6,6
6,6,6,6,6,6,6,5,5,5,4,4,4,4,4,4,4,1,1,1,1,1,3,1,1,1,1,1,1,1,1,2,5,2,2,2,1,1,1,1,4,4,4,4,4,4,1,1,1,1,4,4,4,1,1,1,2,2,2,1,1,1,1,1,1,1,1,1,1,1,1,1,1,1,8,1,1,1,1,1,1,1,2,2,2,2,2,2,2,2,5,5,5,5,6,6,6,6,6,6
6,6,6,6,6,6,6,5,5,5,4,3,4,4,4,4,4,1,1,1,1,1,3,1,1,1,1,1,1,1,1,2,5,2,2,1,1,1,1,1,1,1,4,4,4,1,1,1,1,1,4,4,4,1,1,2,2,2,2,2,1,1,1,1,1,1,8,8,8,1,1,1,1,1,8,8,8,8,1,1,1,1,2,2,2,2,2,2,2,2,5,5,5,5,6,6,6,6,6,6
6,6,6,6,6,6,6,5,5,5,4,3,4,4,4,4,4,1,1,1,1,1,1,1,1,1,1,1,1,1,1,2,5,2,2,2,1,1,1,1,1,1,4,4,4,1,1,1,1,1,1,4,1,1,2,2,2,2,2,2,1,1,1,1,1,1,8,8,8,1,1,1,1,1,1,1,1,8,1,1,1,2,2,2,2,2,2,2,2,2,2,5,5,5,6,6,6,6,6,6
6,6,6,6,6,6,6,5,5,5,4,3,4,4,4,4,4,1,1,1,1,1,1,1,1,1,1,1,1,1,1,2,5,5,2,2,1,1,1,1,1,1,1,1,1,1,1,1,1,1,1,4,1,1,1,2,2,2,2,2,1,2,2,1,1,1,1,1,1,1,1,8,8,8,1,1,1,1,1,1,1,2,2,2,2,2,2,2,2,2,2,2,5,5,6,6,6,6,6,6
6,6,6,6,6,6,6,5,5,5,4,4,4,4,4,4,4,4,1,1,1,1,1,1,1,1,1,1,1,2,2,2,2,5,2,2,2,1,1,1,1,3,3,3,3,3,1,3,1,1,1,1,1,1,1,1,1,1,1,1,2,2,2,2,1,1,1,1,1,1,1,8,8,8,1,1,1,8,8,1,2,2,2,2,2,2,2,2,2,2,2,5,5,5,6,6,6,6,6,6
6,6,6,6,6,6,6,5,5,5,4,4,4,4,4,4,4,4,4,1,1,1,1,1,1,1,1,1,1,1,2,2,2,5,2,2,2,2,1,1,1,1,1,1,1,1,1,1,1,1,1,1,1,2,2,2,2,2,1,1,2,2,2,2,1,1,1,1,1,1,1,8,8,8,1,1,1,8,8,1,2,2,2,2,2,2,2,2,2,2,5,5,5,5,6,6,6,6,6,6
6,6,6,6,6,6,6,5,5,5,4,4,3,4,4,4,4,4,4,4,1,1,1,1,1,1,1,1,2,2,2,2,2,5,2,2,2,2,2,2,2,1,1,1,1,1,1,1,1,1,1,1,1,2,2,2,2,2,2,1,1,2,2,2,1,1,1,1,1,8,1,1,1,1,1,1,1,8,8,1,1,2,2,2,2,2,2,2,2,5,5,5,5,5,6,6,6,6,6,6
6,6,6,6,6,6,6,5,5,5,4,4,3,4,4,4,4,4,4,4,4,4,4,4,4,2,2,2,2,2,2,2,2,5,5,5,2,2,2,2,2,2,2,1,1,1,1,1,1,1,3,1,1,1,1,2,2,2,2,1,1,1,2,2,2,2,1,1,1,8,8,8,8,8,8,8,8,1,1,1,2,2,2,2,2,3,2,2,2,5,5,5,5,5,6,6,6,6,6,6
6,6,6,6,6,6,6,5,5,5,4,4,3,4,4,4,4,4,4,4,1,1,1,1,2,2,2,2,2,2,2,2,2,2,2,5,2,2,2,2,2,2,2,2,1,1,1,1,1,1,1,1,1,1,1,1,1,2,2,2,2,2,2,2,2,2,1,1,1,8,8,8,8,8,8,8,8,2,2,2,2,2,2,2,2,2,2,2,5,5,5,5,5,5,6,6,6,6,6,6
6,6,6,6,6,6,6,5,5,5,4,4,4,4,4,4,4,4,4,1,1,1,1,2,2,2,2,2,2,2,2,2,2,2,2,2,5,5,5,5,5,2,2,2,2,2,2,1,1,1,1,1,1,1,1,1,2,2,2,2,2,2,2,2,2,2,1,1,1,1,1,1,1,1,1,1,2,2,2,2,2,2,2,2,2,2,2,2,5,5,5,5,5,5,6,6,6,6,6,6
6,6,6,6,6,6,6,5,5,5,4,4,4,4,4,4,4,4,4,1,1,1,1,2,2,2,2,2,2,2,2,2,2,2,2,2,2,2,5,5,5,2,2,2,2,2,2,2,1,1,1,1,1,1,1,2,2,2,2,2,3,3,2,2,3,2,1,1,1,1,1,1,1,1,1,1,2,2,2,2,2,2,2,2,2,2,2,2,5,5,5,5,5,5,6,6,6,6,6,6
6,6,6,6,6,6,6,5,5,5,4,3,4,4,4,4,4,4,4,4,4,1,1,1,2,2,2,2,2,2,2,2,2,2,2,2,2,2,2,2,5,2,2,2,2,2,2,2,2,2,2,1,1,1,1,7,7,7,7,7,3,3,3,7,7,3,3,3,3,1,1,1,1,1,1,1,2,2,2,2,2,1,1,1,1,1,1,2,2,2,2,5,5,5,6,6,6,6,6,6
6,6,6,6,6,6,6,5,5,5,4,4,4,4,4,4,4,4,4,1,1,1,1,1,1,1,2,2,2,2,2,2,2,2,2,2,2,8,8,2,5,2,2,8,1,1,1,1,1,1,1,1,1,1,1,7,7,7,7,7,3,3,7,7,7,7,7,3,3,3,1,1,1,1,1,1,2,2,2,2,1,1,1,1,1,1,1,1,2,5,5,5,5,5,6,6,6,6,6,6
6,6,6,6,6,6,6,5,5,5,4,4,4,4,4,4,4,4,1,1,1,1,1,1,1,1,1,1,1,2,2,2,2,2,2,2,2,8,8,2,5,2,8,8,8,1,1,1,1,1,1,1,1,1,3,7,7,7,7,7,3,7,7,7,7,7,7,7,3,3,3,3,1,1,1,1,2,2,2,1,1,1,1,1,1,1,1,1,2,5,5,5,5,5,6,6,6,6,6,6
6,6,6,6,6,6,6,5,5,5,4,4,4,4,4,4,4,1,1,1,1,1,1,1,1,1,2,2,2,2,2,2,2,2,2,8,8,8,8,8,5,2,8,8,8,1,1,8,8,1,1,1,1,1,3,3,7,7,7,7,3,7,7,7,7,7,7,7,7,7,7,7,7,1,1,2,2,2,1,1,1,1,1,1,1,1,1,1,2,5,5,5,5,5,6,6,6,6,6,6
6,6,6,6,6,6,6,5,5,5,4,4,4,4,4,4,1,1,1,1,1,1,1,1,2,2,2,2,2,2,2,2,2,2,8,8,8,8,8,8,5,8,8,8,8,8,8,8,8,8,8,1,1,1,1,3,7,7,7,7,7,7,7,7,7,7,7,7,7,7,7,7,3,1,1,2,2,1,1,1,1,1,1,1,1,1,1,1,2,2,5,5,5,5,6,6,6,6,6,6
6,6,6,6,6,6,6,5,5,5,4,4,4,4,4,1,1,1,1,1,1,1,1,1,1,1,2,2,2,2,2,2,8,8,8,8,5,5,5,5,5,8,8,8,8,8,8,8,8,8,8,1,1,1,1,3,3,7,7,7,7,7,7,7,3,3,7,7,7,7,3,3,3,1,1,2,2,1,1,1,1,1,1,1,1,1,1,1,5,5,5,5,5,5,6,6,6,6,6,6
6,6,6,6,6,6,6,5,5,5,4,4,4,4,4,1,1,1,1,1,1,1,1,1,1,1,1,2,2,2,2,2,8,8,8,8,5,5,8,8,8,8,8,8,8,8,8,8,8,8,8,8,1,1,1,1,3,3,3,3,1,1,1,3,1,1,1,1,1,3,1,1,1,1,4,2,1,1,1,1,1,1,1,1,1,1,1,1,2,2,2,5,5,5,6,6,6,6,6,6
6,6,6,6,6,6,6,5,5,5,4,4,4,4,4,1,1,1,1,1,1,1,1,1,1,1,2,2,2,8,8,8,8,8,8,8,5,8,8,8,8,8,8,8,8,8,8,8,8,8,8,8,8,8,8,8,1,1,1,1,1,1,3,3,3,3,3,3,3,3,5,5,4,4,4,4,1,1,1,1,1,1,1,1,1,1,1,1,4,2,2,5,5,5,6,6,6,6,6,6
6,6,6,6,6,6,6,5,5,5,4,3,3,4,4,1,1,1,1,1,1,1,1,2,2,2,2,2,2,2,8,8,8,8,8,8,5,8,8,8,8,8,8,8,8,8,8,8,8,8,8,8,8,8,1,1,1,1,1,1,1,1,3,3,6,6,5,5,5,5,5,5,5,4,4,4,4,1,1,1,1,1,1,1,1,1,1,1,4,2,5,5,5,5,6,6,6,6,6,6
6,6,6,6,6,6,6,5,5,5,4,3,3,4,4,4,1,1,1,1,1,1,1,1,2,2,2,2,2,2,2,8,8,8,8,8,5,8,8,8,8,8,8,8,8,8,8,8,8,8,8,8,1,1,1,1,1,1,1,1,1,3,3,6,6,6,5,5,5,5,5,5,5,5,4,4,1,1,1,1,1,1,1,1,1,1,1,4,4,5,5,5,5,5,6,6,6,6,6,6
6,6,6,6,6,6,6,5,5,5,4,4,4,4,4,4,4,4,1,1,1,1,1,1,1,1,2,2,2,2,2,8,8,8,8,8,5,8,8,8,8,8,8,8,8,8,8,8,8,8,8,8,8,1,1,1,1,1,1,1,1,3,3,6,6,5,5,5,5,5,5,5,5,4,4,1,2,2,2,2,2,2,2,1,1,1,1,4,4,4,2,5,5,5,6,6,6,6,6,6
6,6,6,6,6,6,6,5,5,5,4,4,4,4,4,4,4,4,4,4,1,1,1,1,1,1,1,2,2,2,2,2,2,2,8,8,5,8,8,8,8,8,8,8,8,8,8,8,8,8,8,1,1,1,1,1,1,3,1,1,3,3,3,3,5,5,5,5,5,5,5,5,4,4,2,2,2,2,2,2,2,2,2,2,2,2,4,4,4,4,2,5,5,5,6,6,6,6,6,6
6,6,6,6,6,6,6,5,5,5,4,4,4,4,4,4,4,4,4,4,1,1,1,1,1,1,1,1,2,2,2,2,2,2,8,8,5,8,8,8,8,8,8,8,8,8,8,8,8,8,8,1,1,1,1,1,3,3,3,3,3,3,3,3,3,5,5,5,5,5,5,5,4,4,2,2,2,2,2,2,2,2,2,2,2,2,4,4,4,4,5,5,5,5,6,6,6,6,6,6
6,6,6,6,6,6,6,5,5,5,4,4,4,4,4,4,4,4,4,4,4,1,1,1,1,1,1,1,1,2,2,2,2,2,2,8,5,2,8,2,2,8,8,8,1,8,8,8,8,8,1,1,1,1,1,1,3,3,3,3,3,3,3,4,4,4,5,5,5,5,4,4,2,2,2,2,2,2,2,2,2,2,2,2,2,2,2,4,5,5,5,5,5,5,6,6,6,6,6,6
6,6,6,6,6,6,6,5,5,5,5,4,4,4,4,4,4,4,4,4,4,4,1,1,1,1,1,1,1,1,2,2,2,2,2,2,5,2,8,2,2,1,8,1,1,1,8,8,1,8,1,1,1,1,3,3,3,3,3,3,3,3,4,4,4,4,4,5,5,4,4,4,2,2,2,2,3,5,2,2,2,2,2,2,2,5,5,5,5,5,5,5,5,5,6,6,6,6,6,6
6,6,6,6,6,6,6,5,5,5,5,4,4,4,4,4,4,4,4,4,4,4,4,1,1,1,1,1,1,1,1,2,2,2,2,2,5,2,2,1,1,1,8,1,1,1,8,1,1,1,1,3,3,3,3,3,3,3,3,3,2,2,2,2,2,2,2,2,2,2,2,2,2,2,2,2,5,5,2,2,2,2,3,2,5,5,2,2,2,5,5,5,5,5,6,6,6,6,6,6
6,6,6,6,6,6,6,5,5,5,5,5,4,4,4,4,4,4,4,4,4,4,4,4,4,4,1,1,1,1,1,2,2,2,2,2,5,2,2,2,1,1,8,1,1,1,1,1,1,1,1,3,3,3,3,3,3,3,2,2,2,2,2,2,2,2,2,2,2,2,3,2,2,2,2,5,5,5,5,3,2,2,2,5,5,5,2,2,2,4,4,5,5,5,6,6,6,6,6,6
6,6,6,6,6,6,6,5,5,5,5,5,5,5,5,5,5,5,4,4,4,4,4,4,4,4,4,1,1,1,1,1,1,2,2,2,5,5,2,2,2,1,1,1,1,1,1,1,1,3,3,3,3,3,3,3,3,3,2,2,2,2,2,2,2,2,2,2,2,2,2,2,2,5,5,5,5,5,5,5,5,5,5,5,5,5,2,2,2,4,5,5,5,5,6,6,6,6,6,6
6,6,6,6,6,6,6,5,5,5,5,5,5,5,5,4,4,4,4,4,4,4,4,4,1,1,1,1,1,1,1,1,1,1,2,2,2,5,2,2,2,2,2,3,3,3,3,3,3,3,3,3,3,3,2,2,2,2,2,2,2,2,2,2,2,2,2,2,2,2,2,5,5,5,5,5,5,5,5,5,5,5,5,5,5,5,2,2,2,5,5,5,5,5,6,6,6,6,6,6
6,6,6,6,6,6,6,5,5,5,5,5,4,3,4,4,4,4,4,4,4,4,1,1,1,1,1,1,1,1,1,1,2,2,2,2,2,5,2,2,2,2,2,2,3,3,3,3,3,3,3,3,3,2,2,2,2,2,2,2,2,2,2,2,2,2,2,2,2,2,2,2,2,5,5,5,5,2,2,2,2,2,2,2,2,2,2,2,2,4,5,5,5,5,6,6,6,6,6,6
6,6,6,6,6,6,6,5,5,5,5,5,4,4,4,4,4,4,4,4,4,1,1,1,1,1,1,1,1,1,1,1,2,2,2,2,2,5,5,2,2,2,2,2,2,2,2,2,2,2,2,2,2,2,2,2,2,2,2,2,3,3,3,3,3,2,2,2,2,2,2,2,2,2,3,5,5,2,2,2,2,2,2,3,3,2,2,2,4,4,4,5,5,5,6,6,6,6,6,6
6,6,6,6,6,6,6,5,5,5,5,5,4,4,4,4,4,4,4,4,1,1,1,1,1,1,1,1,1,1,1,1,2,1,2,2,2,2,5,2,2,2,2,2,2,2,2,2,2,2,2,2,2,2,2,2,3,3,3,3,3,5,5,3,3,3,3,3,2,2,2,2,2,2,3,5,5,2,2,3,2,2,2,3,3,2,2,2,4,4,4,5,5,5,6,6,6,6,6,6
6,6,6,6,6,6,6,5,5,5,5,5,4,4,4,4,4,4,4,4,1,1,1,1,1,1,1,1,1,1,1,1,2,1,1,1,2,2,5,5,5,5,2,2,2,2,2,2,2,2,2,2,2,2,3,3,3,3,3,5,5,5,5,3,3,3,3,3,3,3,2,2,2,2,3,5,2,2,2,2,2,2,2,3,3,2,2,2,4,4,4,5,5,5,6,6,6,6,6,6
6,6,6,6,6,6,6,5,5,5,5,5,4,4,4,4,4,4,4,4,1,1,1,1,1,1,1,1,1,1,1,1,1,1,1,1,1,2,2,2,2,5,5,5,3,3,3,3,3,3,3,3,3,3,3,5,5,5,5,5,5,5,5,5,3,3,3,3,3,3,2,2,2,2,2,5,5,2,2,2,2,2,2,2,2,2,2,4,4,4,4,5,5,5,6,6,6,6,6,6
6,6,6,6,6,6,6,5,5,5,5,4,4,4,4,4,4,4,4,4,4,1,1,1,1,1,1,1,1,1,8,1,1,1,1,1,1,1,1,1,2,2,2,5,5,5,5,5,5,5,5,5,5,5,5,5,5,5,5,5,5,5,5,5,5,5,5,5,5,3,3,3,2,2,2,2,5,5,2,2,2,2,2,2,2,2,2,4,4,4,4,5,5,5,6,6,6,6,6,6
6,6,6,6,6,6,6,5,5,5,5,4,4,4,4,4,4,4,4,4,4,4,1,1,1,1,1,1,1,8,8,1,1,8,1,1,1,1,1,1,1,1,1,2,2,2,2,2,2,2,2,5,5,5,5,5,5,5,5,5,5,5,5,5,5,5,5,5,3,3,3,3,3,3,2,2,2,5,5,5,5,2,2,2,4,4,4,4,4,4,4,5,5,5,6,6,6,6,6,6
6,6,6,6,6,6,6,5,5,5,4,4,4,4,4,4,4,4,4,4,4,4,4,1,1,1,1,8,8,8,8,8,1,8,8,8,8,1,1,1,1,8,8,1,1,1,1,1,2,2,2,2,2,2,2,2,2,2,5,5,5,5,5,5,5,5,5,4,4,4,4,4,4,4,4,4,2,2,2,5,5,4,4,4,4,4,4,4,4,4,5,5,5,5,6,6,6,6,6,6
6,6,6,6,6,6,6,5,5,5,4,3,4,4,4,4,4,4,4,4,4,4,4,1,1,8,8,8,8,8,8,8,1,8,8,8,8,8,1,1,8,8,8,8,8,1,1,1,1,1,1,2,2,2,2,2,2,2,1,1,1,1,5,5,5,5,5,4,4,4,4,4,4,4,4,4,4,4,4,4,5,5,4,4,4,4,4,4,4,4,5,5,5,5,6,6,6,6,6,6
6,6,6,6,6,6,6,5,5,5,4,3,4,4,4,4,4,4,4,4,4,4,1,1,1,1,8,8,8,8,8,8,1,1,1,1,8,8,1,8,1,1,1,8,8,8,1,1,1,1,1,1,2,2,2,2,2,1,1,1,1,1,1,1,5,5,5,4,4,4,4,4,4,4,4,4,4,4,4,4,4,5,5,4,4,4,4,4,4,4,5,5,5,5,6,6,6,6,6,6
6,6,6,6,6,6,6,5,5,5,4,4,4,4,4,4,4,4,4,1,8,1,1,1,1,1,1,8,1,1,8,1,8,8,1,8,1,1,8,8,8,8,1,1,1,1,1,1,1,1,1,1,1,2,2,1,1,1,1,1,1,1,1,1,5,5,5,4,4,4,4,4,4,4,4,4,4,3,3,3,5,5,5,5,5,5,5,5,5,5,5,5,5,5,6,6,6,6,6,6
6,6,6,6,6,6,6,5,5,5,4,4,4,4,4,4,1,1,1,1,1,1,1,8,8,8,1,1,1,1,1,8,8,8,8,8,1,8,8,8,8,8,8,8,8,1,8,8,8,8,8,8,1,1,1,1,1,1,1,1,1,1,1,1,1,5,5,4,4,4,4,4,4,4,4,4,4,3,3,3,5,4,4,4,4,5,5,5,5,5,5,5,5,5,6,6,6,6,6,6
6,6,6,6,6,6,6,5,5,5,4,4,4,4,4,4,4,4,1,1,1,8,8,8,8,8,8,1,1,1,1,1,1,1,1,1,8,8,1,8,8,8,8,8,8,1,8,8,8,8,8,8,8,8,1,1,1,1,1,1,1,1,1,1,5,5,5,4,4,4,4,4,4,4,4,4,4,4,4,4,4,4,5,5,5,5,5,5,5,5,5,5,5,5,6,6,6,6,6,6
6,6,6,6,6,6,6,5,5,5,4,4,4,4,4,4,4,4,4,1,1,8,8,8,8,8,8,1,1,1,1,1,8,1,1,1,1,1,1,1,1,1,8,8,8,1,8,8,8,8,8,8,8,1,1,1,1,1,1,1,1,1,5,5,5,5,5,5,5,5,4,4,4,4,4,4,4,4,4,4,4,4,4,5,5,5,5,5,1,1,1,5,5,5,6,6,6,6,6,6
6,6,6,6,6,6,6,5,5,5,4,4,4,4,4,4,4,4,4,1,1,1,1,8,8,1,1,1,1,1,8,8,8,8,1,1,1,1,1,1,1,1,1,1,1,1,1,1,8,8,1,1,1,1,1,1,1,1,1,1,1,1,5,5,5,5,5,5,5,5,4,4,4,4,4,4,4,4,4,4,4,5,5,5,5,5,5,5,1,1,1,1,5,5,6,6,6,6,6,6
6,6,6,6,6,6,6,5,5,5,4,4,4,4,4,4,4,4,4,4,4,4,1,1,1,1,1,1,3,3,3,3,3,3,3,4,4,4,4,4,4,4,4,4,1,1,1,1,1,1,1,1,1,1,1,1,1,1,1,5,5,5,5,5,5,5,5,5,5,5,5,5,4,4,4,4,4,4,4,5,5,5,5,5,5,5,5,1,1,1,1,1,5,5,6,6,6,6,6,6
6,6,6,6,6,6,6,5,5,5,4,4,4,4,4,4,4,4,4,4,4,4,4,4,4,4,4,4,4,4,4,4,4,4,4,4,4,4,4,4,4,4,4,4,4,4,4,4,4,1,1,1,1,1,1,1,1,1,5,5,5,5,5,5,5,5,5,5,5,5,5,5,4,4,4,4,4,5,5,5,5,5,5,5,5,5,1,1,1,8,1,1,1,5,6,6,6,6,6,6
6,6,6,6,6,6,6,5,5,5,4,4,4,4,4,4,4,4,4,4,4,4,4,4,4,4,4,4,4,4,4,4,4,4,4,4,4,4,4,4,4,4,4,4,4,4,4,4,4,4,4,1,1,1,1,1,1,5,5,5,5,5,5,5,5,6,6,5,5,5,5,5,5,5,4,4,5,5,5,5,5,1,1,1,1,1,1,8,8,8,8,1,1,5,6,6,6,6,6,6
6,6,6,6,6,6,6,5,5,5,4,4,4,4,4,4,4,4,4,4,4,4,4,4,4,4,4,4,4,4,4,4,4,4,4,4,4,4,4,4,4,4,4,4,4,4,4,4,4,4,4,4,4,4,1,5,5,5,5,5,5,5,5,5,5,6,6,6,5,5,5,5,5,5,5,5,5,5,1,1,1,1,1,8,8,8,8,8,8,8,1,1,5,5,6,6,6,6,6,6
6,6,6,6,6,6,6,5,5,5,5,5,5,5,5,5,5,5,5,5,5,5,5,5,5,5,5,5,5,5,5,5,5,5,5,5,5,5,5,5,5,5,5,5,5,5,5,5,5,5,5,5,5,5,5,5,5,5,5,5,5,5,5,5,5,6,6,6,6,5,5,5,5,5,5,5,5,5,5,5,5,1,1,1,8,1,1,1,1,5,1,1,5,5,6,6,6,6,6,6
6,6,6,6,6,6,6,5,5,5,5,5,5,5,5,5,5,5,5,5,5,5,5,5,5,5,5,5,5,5,5,5,5,5,5,5,5,5,5,5,5,5,5,5,5,5,5,5,5,5,5,5,5,5,5,5,5,5,5,5,5,5,5,5,6,6,6,6,6,6,6,6,5,5,5,5,5,5,5,5,5,5,1,1,1,1,5,5,5,5,1,5,5,5,6,6,6,6,6,6
6,6,6,6,6,6,6,5,5,5,5,5,5,5,5,5,5,5,5,5,5,5,5,5,5,5,5,5,5,5,5,5,5,5,5,5,5,5,5,5,5,5,5,5,5,5,5,5,5,5,5,5,5,5,5,5,5,5,5,5,5,6,6,6,6,6,6,6,6,6,6,6,5,5,5,5,5,5,5,5,5,5,5,5,5,5,5,5,5,5,1,5,5,5,6,6,6,6,6,6
6,6,6,6,6,6,6,6,6,6,6,6,6,6,6,6,6,6,6,6,6,6,6,6,6,6,6,6,6,6,6,6,6,6,6,6,6,6,6,6,6,6,6,6,6,6,6,6,6,6,6,6,6,6,6,6,6,6,6,6,6,6,6,6,6,6,6,6,6,6,6,6,6,6,6,6,6,6,6,6,6,6,6,6,6,6,6,6,6,6,6,6,6,6,6,6,6,6,6,6
6,6,6,6,6,6,6,6,6,6,6,6,6,6,6,6,6,6,6,6,6,6,6,6,6,6,6,6,6,6,6,6,6,6,6,6,6,6,6,6,6,6,6,6,6,6,6,6,6,6,6,6,6,6,6,6,6,6,6,6,6,6,6,6,6,6,6,6,6,6,6,6,6,6,6,6,6,6,6,6,6,6,6,6,6,6,6,6,6,6,6,6,6,6,6,6,6,6,6,6
6,6,6,6,6,6,6,6,6,6,6,6,6,6,6,6,6,6,6,6,6,6,6,6,6,6,6,6,6,6,6,6,6,6,6,6,6,6,6,6,6,6,6,6,6,6,6,6,6,6,6,6,6,6,6,6,6,6,6,6,6,6,6,6,6,6,6,6,6,6,6,6,6,6,6,6,6,6,6,6,6,6,6,6,6,6,6,6,6,6,6,6,6,6,6,6,6,6,6,6
6,6,6,6,6,6,6,6,6,6,6,6,6,6,6,6,6,6,6,6,6,6,6,6,6,6,6,6,6,6,6,6,6,6,6,6,6,6,6,6,6,6,6,6,6,6,6,6,6,6,6,6,6,6,6,6,6,6,6,6,6,6,6,6,6,6,6,6,6,6,6,6,6,6,6,6,6,6,6,6,6,6,6,6,6,6,6,6,6,6,6,6,6,6,6,6,6,6,6,6
6,6,6,6,6,6,6,6,6,6,6,6,6,6,6,6,6,6,6,6,6,6,6,6,6,6,6,6,6,6,6,6,6,6,6,6,6,6,6,6,6,6,6,6,6,6,6,6,6,6,6,6,6,6,6,6,6,6,6,6,6,6,6,6,6,6,6,6,6,6,6,6,6,6,6,6,6,6,6,6,6,6,6,6,6,6,6,6,6,6,6,6,6,6,6,6,6,6,6,6
6,6,6,6,6,6,6,6,6,6,6,6,6,6,6,6,6,6,6,6,6,6,6,6,6,6,6,6,6,6,6,6,6,6,6,6,6,6,6,6,6,6,6,6,6,6,6,6,6,6,6,6,6,6,6,6,6,6,6,6,6,6,6,6,6,6,6,6,6,6,6,6,6,6,6,6,6,6,6,6,6,6,6,6,6,6,6,6,6,6,6,6,6,6,6,6,6,6,6,6
